     #########
     #...  . #
  #### #.#.  #
###    ......#
#   $ $ $#..##
# $####..####
#  $   ###  ##
# $$$ $ $ $@ #
#  $ $ $ $ $ #
##          ##
 ############
Author: 村瀬 芳生
Comment:
格納の難しい面を作ろうとしたものです。
広さ78、荷物16、荷物率20.5%です。
Comment-End:
