  ######
  #    #
###$$  #
# $ #$ #
# $ #  #
# $ @# ##
# $#.*. #
#  $* #.#
##  . #.#
 ###... #
   #    #
   ######
Title:中日ドラゴンズ
Author:村瀬 芳生
Comment:
昔の帽子のマークです。これをかぶってた選手はずいぶんと
減りました…。簡単に解かれるようでは、優勝はできません！
Comment-End:
