 ##########
 #        #
 # ##$# # #
 # .....# #
###$$$$$  #
#  * .@*###
#  $$$$$  #
# # ...## #
#  .#. .# #
### #$#   #
  #   #####
  #####
Title: 束
Author: 村瀬 芳生
Comment:
束（たば）です。文字を象るのは難しいです・・・。
Comment-End:
