  ####
  #  ###
### $  ##
# $...$ #
# ##. # #
#  .$.# #
# $#. $ #
## #$##@#
 #      #
 ########
Title: 木
Author: 村瀬 芳生
Comment:
木（き）です。植物の木の形から作られた、象形文字です。
Comment-End:
