  #####
  # @ #
### * ###
#  ...  #
# ##$## #
# $   $ #
###   ###
  #   #
  #####
Title: ルンバ
Author: 村瀬 芳生
Comment:
「ワルツ」と同じ日に作りました。
似てますが、解き方はどうでしょう。
Comment-End:
