 #####
##   ###
# .... #
# #. # #
# $$$$ #
# $.@$###
# $$$$  #
##$..$# #
 # .. # #
 #.##.  #
 #    ###
 ######
Title:頁
Author: 村瀬 芳生
Comment:
頁（おおがい）です。これで「木寸シ束頁」とそろいましたね。
作成日は 2000/02/13です。
Comment-End:
