###########
#@$   ....##
# $$$$#....#
# $  $..***##
##   # ##.. #
# $$$#  ##  #
#    ## #  ##
#  $$ #    #
#     ###  #
####### ####
Author: 村瀬 芳生
Comment:
私の第１作です。中学のころかな。
昔はこんなに荷物の多いものを作ってましたけど、
今は荷物6個以下が多いですね。
広さ66、荷物15、荷物率22.7%と狭いです。
Comment-End:
