 #######
##  #  ###
# $ # $  #
#  .@.   #
##$ # $###
 # . . #
 #######
Title: For ban 9
Collection: Novoban
Author: François Marques
AuthorMail: sokoban@online.fr
AuthorPage: http://sokoban.online.fr/
Date: 2001/01
