<!DOCTYPE HTML PUBLIC "-//IETF//DTD HTML 2.0//EN">
<HTML><HEAD>
<TITLE>404 Not Found</TITLE>
</HEAD><BODY>
<H1>Not Found</H1>
The requested URL /levels/novoban/novoban02.xsb was not found on this server.<P>
<HR>
<ADDRESS>Apache/ProXad [Dec 22 2004 18:41:28] Server at sokoban.online.fr Port 80</ADDRESS>
</BODY></HTML>
