  #####
 ##   #
 #  # #
##$..$#
# .$$.##
# $..$ #
## #@  #
 #   ###
 #####
Title: Hexa ban 2
Collection: Sokompact
Author: François Marques
AuthorMail: sokoban@online.fr
AuthorPage: http://sokoban.online.fr/
Date: 2001/03 François Marques <sokoban@online.fr>

