 #####
 # @ #
##$ $#
#  $ ###
# .*.  #
##.*.  #
 # $ ###
 # * #
 #  ##
 ####
Title: Halloween
Collection: Sokompact
Author: François Marques
AuthorMail: sokoban@online.fr
AuthorPage: http://sokoban.online.fr/
Date: 2001/10/30
Comment:
Un petit air de Picokosmos 12, créé par Aymeric un jour avant, mais la résolution est très différente !
Comment-End: