  ####
###  #
# $  ###
#@#.$  #
# $ $# #
## . ..#
 #  ####
 ####
Title: For ban 48
Collection: Sokompact
Author: François Marques
AuthorMail: sokoban@online.fr
AuthorPage: http://sokoban.online.fr/
Date: 2001/08
