  #####
  #   #
### # #
# . * #
#  $#$###
##. * @ #
 #  #   #
 ########
Title: For ban 51
Collection: Sokolate
Author: François Marques
CAuthorMail: sokoban@online.fr
AuthorPage: http://sokoban.online.fr/
Date: 2001/08
