  ####
  #  ###
###  $ #
# ...@ #
# $# $ #
# $..$##
#  #  #
#######
Title: Penta ban 16
Collection: Sokolate
Author: François Marques
AuthorMail: sokoban@online.fr
AuthorPage: http://sokoban.online.fr/
Date: 2001/05
