########
#   .  #
#   $  #
## ***##
#      #
#  *** #
###   ##
 # *** #
 #  @  #
 #######
Title: The ladder
Collection: Kokoban
Author: François Marques
AuthorMail: sokoban@online.fr
AuthorPage: http://sokoban.online.fr/
Date: 2001/09
