    #####
    #   ##
  ###$   #
 ## .*.  #
## $ $*$##
# .*+ . #
#  $*$ ##
### .  #
  ######
Title: Deca ban 2
Collection: Kokoban
Author: François Marques
AuthorMail: sokoban@online.fr
AuthorPage: http://sokoban.online.fr/
Date: 2001/06
