  #####
  #   ###
  #  .  #
### * * #
#   $#$##
#   *@* #
#  # .  #
#########
Title: Hexa ban 5
Collection: Kokoban
Author: François Marques
AuthorMail: sokoban@online.fr
AuthorPage: http://sokoban.online.fr/
Date: 2001/03
