 #######
##  +  ##
#  * *  #
# * * * #
#  *$*  #
# * * * #
#  * *  #
##     ##
 #######
Title: The diamond
Collection: Kokoban
Author: François Marques
AuthorMail: sokoban@online.fr
AuthorPage: http://sokoban.online.fr/
Date: 2000/01

